1111111111111
1000C000C0001
10E0000000E01
1000011100001
10C001P100C01
100001C100001
10E0000000E01
1000C000C0001
1111111111111