111111111
1000C0001
1C1011101
1110001C1
1C000C101
11PE10001
111111111