111111111111111111
100000000001000001
10000000000100C001
1000111C0001000001
100E00100001000001
1111111000000000C1
1000C0001010001001
10000C0010100C10E1
101111111E11111C11
101000000000000001
101C100000E0000001
1C1111100000000001
1010000P00000E0001
101100110000000001
100000C1000000C001
111111111111111111